EEEEEEEEGEEEEEEEEEEEEEEEEEEEEEEE
EEEEEEEBBBEEEEGEEEEEEEEEEEEEEEEE
EEEEPEEEEEEEEEBBEEEEEEEEEEEEEEEE
EEEBBBEEEEEEEEEEEEBBBBEEEEEEEEEE
EEEEEEEEEEEEEEEEEEEEEEEEEEEEEEEE
TEEGTETGEEEEEEETTGTEETEEETGTEEEE
DDDDDDDDDDDEEDDDDDDDDDDDDDDDDDDD	