EEEEEEEEEGEEEEEEEEEEEEEEEEEEEEEE
EEEEEEEEDDDEEEGEEEEEEEEEEEEEEEEE
EEEEEPEEEEEEEDDEEEEEEEEEEEEEEEEE
EEEEDDDEEEEEEEEEEEDDDDEEEEEEEEEE
EEEEEEEEEEEEEEEEEEEEEEEEEEEEEEEE
EEEGEEEGEEEEEEEEEEEEEEEEEEEEEEEE
DDDDDDDDDDDEEDDDDDDDDDDDDDDDDDDD