EEEEEEEEEEEEEEEEEEEEEEEEEEEEEEEE
EEEEEEEEKEEEEEEEEEEEEEEEEEEEEEEE
EEEEEEEBBBEEEEKEEEEEEEEEEEEEEEEE
EEEEPEEEEEEEEEBBEEEEEEEEEEEEEEEE
EEEBBBEEEEEEEEEEEEBBBBEEEEEEEEEE
EEEEEEEEEEEEEEEEEEEEEEEEEEEEEEGG
TEEKTETKEEEEEEETTKTEETEEETKTEGDD
GGGGGGGGGGGEEGGGGGGGGGGGGGGGGDDD