EEEEEEEEEEEEEEEEEEEEE
EEEEDDEEEEDDDDEEEEEEE
EEEEEEEEEEEEEEEEEEEEE
EPEEEEEEEEEEEEEEEEEEE
DDDDDDDDDDDDDDDDDDDDD