EEEEEEEEEGEEEEEEEEEEEEEEEEEEEEEE
EEEEEEEEDDDEEEEEEEEEEEEEEEEEEEEE
EEEEEPEEEEEEEDDEEEEEEEEEEEEEEEEE
EEEEDDDEEEEEEEEEEEDDDDEEEEEEEEEE
EEEEEEEEEEEEEEEEEEEEEEEEEEEEEEEE
EEEGEEEGEEEEEEEEEEEEEEEEEEEEEEEE
DDDDDDDDDDDEEDDDDDDDDDDDDDDDDDDD