EEEEEEEEEGEEEEEEEEEEEEEEEEEEEEEE
EEEEEEEEDDDEEEGEEEEEEEEEEEEEEEEE
EEEEEPEEEEEEEDDEEEEEEEEEEEEEEEEE
EEEEDDDEEEEEEEEEEEDDDDEEEEEEEEEE
EEEEEEEEEEEEEEEEEEEEEEEEEEEEEEEE
EEEGTETGEEEEEEETTGTEETEEETETEEEE
DDDDDDDDDDDEEDDDDDDDDDDDDDDDDDDD